########################################
#S.##..#.....###.................##....#
##.#.....#.#...#.######.###..###.#..####
#..#.###.#.#.###.#....###.##.#.........#
##...#.###.#.#...#.#.##......###########
####.....###.#.###.#.#..#..#..#........#
#.....##.#...#.....#.##.#.############.#
#####..###.#########.#..#.#............#
#........#.#.........##.#.##.###.#####.#
#.###.##.#.#.#######..#.#..#.#.#.....#.#
#...#..#.#.#.#........#.####.#.#####.#.#
###.####.#.#.###.#.#..#......#.......#.#
#...#....#.#.....#######.#####.#####.#.#
###.#.#.##.#####.#.....#.......#.....#.#
#...###....###.#.#.#.#.###############.#
#.#...########.#.#.#.#.................#
###.#.#........#.#.#########.###########
#...#....#####.#.#...#.....#.......#...#
#.########...###.#.#.#.#####.#.###.#.###
#..........#.....#.#.........#...#....E#
########################################